NO images/blue_hole.xpm
WE images/wall.xpm
SO images/black_bricks.xpm
EA images/sama.xpm

F 139,255,19
C 135,206,235


111111111111111111111111111111111
100000000011000000000000000000001
101100000111000000000000000000001
100100000111111111111111000000001
1111111111             1000000001
1000000001             1111111111
111111111111111111111111111111111
111111111111111111111111111111111
1111011111             1100000001    
1111011111             1100000001    
1100000011             1100011111    
1000000001             1010001111
100000000111111111111111100011111    
11000001110101011111011110N011  1  
11110111 1110101 101111010011   1    
111111111111111111111111111111111






