NO images/blue_hole.xpm
SO images/black_bricks.xpm
WE images/wall.xpm
EA images/sama.xpm

C 135,206,235
F 139,69,19


111111111111111111111111111111111
1  110000111000001110000000000011
1 1100100000011100000111001111001
111001110111111111111111100001001
1100111001             1001111001
1000010011      1      1001000011
1000000111     11      1001111001
1011100011    1111     1100000001
1010000001      1      1001000011
1011100101             1010100111
1010001101111111111111110010011 1
101110100000100010001001N00011  1
10000000001000100010001000011  11
111111111111111111111111111111111