NO images/blue_hole.xpm
SO images/black_bricks.xpm
WE images/wall.xpm
EA images/sama.xpm

C 135,206,235
F 139,69,19


11111111111111111111111111111111111111111111111
10011000011100000111000000000001100000000000D01
10110010000001110000011100111100110011110111101
11100111011111111111111111111111111111010000101
1110011101                           1001000101
1100111001         111      11111111 1000110101
1000010011       111      111    111 1001110001
1000000111     111 111         111   1000110101
1011100011   111  111       111      1100111001
1010D00001 11111111111   111         1001110001
1011100101      111    111           1011110011
1011100101     111   11111111111     1011110011
1010101101                           1010100111
10110011011111111111111111111111111111010100111
1011101000001000100010001000D000100000110001101
100000000010D0100000D00W00011001100000D00011001
11111111111111111111111111111111111111111111111  