11111111111111111
10000000100000011
10000000000000011
10000000000000011
10000000000000011
10000000000000011
1000000101000011
10000000N00000011
11111111111111111