111111111111111111111
100N00000000000000001
100000000000001111111
100100000000000000001
100001111111111111111
111111